10x16* o12
**1*************
*      *      **
*  *   ***     *
*    *        **
*   *         **
*             **
* *           **
****************
***            2
****************

