5x5* 
***1*
*** *
* * *
*   *
*2***