10x30* o12
**************1***************
*  **                        *
*****   *         *    *     *
*                  * * *     *
**  * * *   *                *
*  *  *     *           *  * *
** *                *       **
** *  *                 *    *
2                   * ** *   *
******************************